################################################
#                                              #
#  1     E              I          C         #
#                                     #####    #
#                  W                       #   #
#    E    ##       ###      S      L     #   #
#        #  #              ###           #   #
#  P    #    #    I                  T   #
################################################